24 24 24 24 24 24 24 24 24 24 24 24 24 24 24 24 24 24 24 24 24 24 24 24 24 24 24 24 24 24 24 24 24 24 24 24 24 24 24 24 24 24 24 24 24 24 24 24 24 24 
24 30 30 24 19 19 19 19 19 19 19 19 32 24 19 19 19 19 19 19 19 19 19 32 19 24 24 30 31 24 24 30 19 19 19 19 19 24 19 19 19 19 19 19 19 19 24 19 30 24 
24 30 30 19 19 19 19 19 19 19 19 19 19 24 19 19 19 19 19 19 19 19 19 19 19 24 24 30 30 24 24 19 19 19 24 24 19 24 19 19 19 19 19 31 19 19 24 19 19 24 
24 19 19 24 19 19 19 19 19 19 24 19 19 24 19 19 19 19 19 19 19 19 19 19 19 24 24 24 30 24 24 19 19 19 19 19 19 19 19 19 19 19 19 19 19 19 19 19 19 24 
24 19 19 24 19 19 19 19 19 24 24 19 19 24 24 24 24 24 24 24 24 19 19 19 19 24 24 24 24 24 24 19 19 24 19 19 31 19 19 19 19 19 19 19 19 19 19 19 19 24 
24 19 19 19 19 19 19 24 19 19 19 19 19 24 19 19 19 19 19 19 19 19 19 19 19 19 19 19 19 24 24 19 19 24 19 19 19 19 19 19 19 19 19 19 19 19 19 19 19 24 
24 19 19 19 24 19 24 24 19 19 19 24 19 24 19 19 19 19 19 19 24 19 19 19 24 24 24 19 19 24 24 19 19 24 19 19 19 19 19 19 19 19 19 19 19 19 24 24 19 24 
24 19 19 19 19 19 19 19 19 19 19 24 19 24 24 24 24 24 19 19 24 19 19 19 24 24 24 19 19 24 24 19 19 24 19 19 19 19 19 19 19 19 19 19 19 19 19 24 19 24 
24 24 24 19 19 19 19 19 24 19 19 19 19 24 19 19 19 19 19 19 24 19 19 19 19 19 19 19 32 24 24 19 19 19 19 19 19 19 19 19 19 29 29 19 19 19 19 19 19 24 
24 24 24 24 24 24 24 24 24 24 24 24 24 24 24 24 24 24 24 24 24 24 24 24 24 24 24 24 24 24 24 19 24 32 24 19 19 19 19 19 19 19 19 19 19 19 19 19 32 24 
24 29 24 19 19 19 19 19 30 19 19 19 19 29 32 19 19 19 19 19 19 19 19 19 31 19 29 19 19 24 24 19 24 24 24 24 24 24 24 24 24 24 24 24 24 24 24 24 24 24 
24 24 24 19 19 19 19 19 19 19 19 19 19 19 19 19 19 19 19 19 19 19 19 19 19 19 19 19 19 24 24 19 19 19 19 19 30 19 19 19 19 19 19 19 19 19 19 19 19 24 
24 19 19 19 19 19 19 28 28 19 19 19 19 19 19 19 19 19 19 19 19 19 24 19 19 19 19 19 19 24 24 19 19 19 19 19 19 19 19 19 19 19 19 19 19 19 19 19 19 24 
24 19 19 19 19 19 19 19 19 19 19 19 19 19 19 19 19 19 19 19 19 19 19 19 19 19 19 19 19 24 24 19 19 19 19 19 19 19 19 19 19 19 19 30 19 19 19 19 19 24 
24 19 19 19 19 19 19 19 19 19 19 19 19 19 19 19 19 19 28 28 28 28 19 19 19 19 19 19 19 24 24 19 24 24 24 24 24 24 24 24 24 24 24 24 24 24 24 24 24 24 
24 19 19 24 19 24 19 19 19 19 19 24 19 19 19 19 19 19 19 19 19 19 19 19 19 19 19 19 24 24 29 19 19 24 24 19 19 19 24 19 19 19 19 24 19 19 19 24 24 24 
24 19 19 24 19 19 19 19 24 19 19 19 19 19 24 19 19 19 19 19 24 24 24 24 19 19 19 19 24 24 19 19 19 19 19 19 19 19 24 19 30 30 19 24 19 30 19 24 24 24 
24 19 19 24 19 19 19 19 19 19 19 19 19 19 24 19 19 19 19 19 24 31 19 24 19 19 19 24 24 24 24 19 19 19 19 19 19 24 24 19 30 30 19 24 19 30 19 24 24 24 
24 30 30 24 24 30 19 19 19 19 19 19 30 24 24 19 19 30 19 19 24 19 19 19 19 19 32 24 24 24 24 19 19 19 19 19 24 24 24 19 19 19 19 24 19 19 19 24 24 24 
24 24 24 24 24 24 24 24 24 24 24 24 24 24 24 24 24 24 24 24 24 24 24 24 24 24 24 24 24 24 24 24 24 24 24 24 24 24 24 24 24 24 24 24 24 24 24 24 24 24 
24 24 24 24 24 24 24 24 24 24 24 24 24 24 24 24 24 24 24 24 24 24 24 24 24 24 24 24 24 24 24 24 24 24 24 24 24 24 24 24 24 24 24 24 24 24 24 24 24 24 
24 24 24 24 24 24 24 24 24 24 24 24 24 24 24 24 24 24 24 24 24 24 24 24 24 24 24 24 24 24 24 24 24 24 24 24 24 24 24 24 24 24 24 24 24 24 24 24 24 24 
33 33 33 33 33 33 33 33 33 33 33 33 33 33 33 33 33 33 33 33 33 33 33 33 33 33 33 33 33 33 33 33 33 33 33 33 33 33 33 33 33 33 33 33 33 33 33 33 33 33 
33 33 33 33 33 33 33 33 33 33 33 33 33 33 33 33 33 33 33 33 33 33 33 33 33 33 33 33 33 33 33 33 33 33 33 33 33 33 33 33 33 33 33 33 33 33 33 33 33 33 
33 33 33 33 33 33 33 33 33 33 33 33 33 33 33 33 33 33 33 33 33 33 33 33 33 33 33 33 33 33 33 33 33 33 33 33 33 33 33 33 33 33 33 33 33 33 33 33 33 33 
33 19 19 19 19 19 19 19 19 19 19 19 19 19 19 19 19 19 19 19 19 19 19 19 19 33 19 19 19 19 19 19 19 19 19 19 19 19 19 19 19 19 19 19 19 19 19 19 19 33 
33 19 33 33 33 33 33 33 33 33 33 33 33 33 33 33 33 33 33 33 33 33 33 33 19 33 19 33 33 33 33 33 33 33 33 33 33 33 33 33 33 33 33 33 33 33 33 33 19 33 
33 19 33 33 19 19 19 19 19 19 19 19 19 19 19 19 33 19 19 19 19 19 19 19 19 33 19 19 19 19 19 19 19 19 19 19 19 19 33 19 19 19 19 19 19 19 33 33 19 33 
33 19 33 33 19 19 19 19 19 19 33 19 19 19 19 19 19 19 30 30 19 33 19 19 19 33 19 19 19 19 33 19 19 19 19 19 19 19 19 19 19 19 19 19 33 19 33 33 19 33 
33 19 33 33 19 33 33 33 33 33 33 33 33 33 33 33 33 33 33 33 33 33 33 33 33 33 33 33 33 33 33 33 33 33 33 33 33 33 33 33 33 33 33 33 33 19 33 33 19 33 
33 19 33 33 19 30 19 19 19 19 19 19 19 19 19 19 19 33 31 19 19 19 19 29 19 19 19 19 19 19 19 19 19 19 19 19 19 19 19 33 19 19 19 31 33 19 33 33 19 33 
33 19 33 33 19 33 19 33 33 19 19 19 19 19 19 19 19 19 19 19 19 19 33 33 19 19 19 33 33 19 19 19 19 19 19 19 19 19 19 33 19 19 19 19 33 19 33 33 19 33 
33 19 33 33 19 33 19 19 19 19 19 19 19 19 19 19 19 33 19 19 19 33 33 19 19 19 19 19 33 33 19 19 19 19 19 19 19 19 19 19 19 19 19 19 33 19 33 33 19 33 
33 19 33 33 19 33 19 19 19 19 19 19 19 19 19 19 19 19 19 19 33 33 19 19 19 19 19 19 19 33 33 19 19 19 19 19 19 19 19 19 19 19 19 19 33 19 33 33 19 33 
33 19 33 33 19 33 19 19 19 19 33 19 19 19 19 19 19 19 19 33 33 19 19 19 19 19 19 19 19 19 33 33 19 19 19 19 19 19 19 19 19 19 19 19 33 19 33 33 19 33 
33 19 33 33 19 33 19 19 19 19 19 19 19 19 19 19 19 19 19 33 33 19 19 19 19 19 19 19 19 19 33 33 19 19 19 19 19 19 19 19 19 19 19 19 33 19 33 33 19 33 
33 19 33 33 19 33 19 19 19 19 19 19 19 19 19 19 19 19 19 33 33 19 19 19 19 19 19 19 19 19 33 33 19 19 19 19 19 19 30 30 30 19 19 19 33 19 33 33 19 33 
33 19 33 33 19 19 19 19 19 33 19 19 19 19 19 19 19 19 19 33 33 19 19 19 19 19 19 19 19 19 33 33 19 19 19 19 19 19 30 30 30 19 19 19 33 19 33 33 19 33 
33 19 33 33 19 19 19 19 33 33 19 19 19 19 19 33 33 33 33 33 33 19 19 19 19 19 19 19 19 19 33 33 33 33 33 33 19 19 30 30 30 19 19 19 33 19 33 33 19 33 
33 19 33 33 33 33 19 19 19 19 19 33 19 19 19 19 19 19 19 33 33 19 19 19 19 19 19 19 19 19 33 33 19 19 19 33 19 19 19 19 19 19 19 19 33 19 33 33 19 33 
33 19 33 33 19 33 19 19 19 19 19 19 19 19 19 19 19 19 19 33 33 19 19 19 19 19 19 19 19 19 33 33 19 19 19 33 19 19 19 19 19 19 19 19 33 19 33 33 19 33 
33 19 33 33 19 33 19 19 19 19 19 19 19 19 19 19 19 19 19 19 33 33 19 19 19 19 19 19 19 33 33 19 19 19 19 33 19 19 19 19 19 19 19 19 33 19 33 33 19 33 
33 19 33 33 19 33 19 19 19 19 19 19 19 19 19 19 19 33 19 19 19 33 33 19 19 19 19 19 33 33 19 19 19 19 19 33 19 19 19 19 19 19 19 19 33 19 33 33 19 33 
33 19 33 33 19 33 19 33 19 19 19 19 19 19 19 19 19 19 19 19 19 19 33 33 19 19 19 33 33 19 19 19 19 19 19 33 19 19 19 19 19 19 19 19 33 19 33 33 19 33 
33 19 33 33 19 33 30 19 19 19 33 19 19 19 19 19 30 30 19 19 19 19 32 33 19 19 19 33 19 19 19 19 29 19 19 19 19 19 32 19 19 19 19 32 33 19 33 33 19 33 
33 19 33 33 19 33 33 33 33 33 33 33 33 33 33 33 33 33 33 33 33 33 33 33 33 19 33 33 33 33 33 33 33 33 33 33 33 33 33 33 33 33 33 33 33 19 33 33 19 33 
33 19 33 33 19 19 19 19 19 19 19 19 19 19 19 19 19 19 19 19 19 19 19 19 33 19 19 19 19 19 19 19 19 19 19 19 19 19 19 19 19 19 19 19 19 19 33 33 19 33 
33 19 33 33 33 33 33 33 33 33 33 33 33 33 33 33 33 33 33 33 33 33 33 33 33 33 33 33 33 33 33 33 33 33 33 33 33 33 33 33 33 33 33 33 33 33 33 33 19 33 
33 19 19 19 19 19 19 19 19 19 19 19 19 19 19 19 19 19 19 19 19 19 19 19 30 30 30 19 19 19 19 19 19 19 19 19 19 19 19 19 19 19 19 19 19 19 19 19 19 33 
33 33 33 33 33 33 33 33 33 33 33 33 33 33 33 33 33 33 33 33 33 33 33 33 33 33 33 33 33 33 33 33 33 33 33 33 33 33 33 33 33 33 33 33 33 33 33 33 33 33
