36 36 36 36 36 36 36 36 36 36 36 36 36 36 36 36 36 36 36 36 36 36 36 36 36 36 36 36 36 36 36 36 36 36 36 36 36 36 36 36 36 36 36 36 36 36 36 36 36 36 
36 35 35 35 35 36 35 35 36 35 35 35 39 36 36 36 36 36 36 36 35 35 35 35 35 35 35 35 35 35 35 35 35 35 35 35 35 35 35 35 35 35 35 35 35 35 35 35 35 36 
36 35 35 35 34 36 35 34 36 35 35 35 35 36 35 35 35 35 35 35 35 35 35 35 35 35 35 35 35 35 35 35 35 35 35 35 35 35 34 35 35 35 35 35 35 35 35 35 35 36 
36 35 34 35 34 36 35 34 36 35 35 35 34 36 35 35 35 35 35 35 35 35 35 35 35 35 35 35 35 35 35 35 38 38 35 35 35 35 35 35 35 35 38 35 35 35 35 35 35 36 
36 35 36 36 36 36 34 34 36 36 36 36 36 35 35 35 35 35 35 34 34 34 35 35 35 35 35 35 35 35 35 35 38 38 35 35 35 35 35 35 35 35 35 35 35 35 35 35 35 36
36 34 35 35 35 35 35 35 35 34 35 35 35 35 35 34 35 35 35 34 34 34 35 35 35 35 38 35 35 35 35 35 35 35 35 35 35 35 35 35 35 35 35 35 35 35 35 34 35 36 
36 35 36 36 36 36 35 39 36 35 36 36 36 36 35 35 35 35 35 34 34 34 35 35 35 35 35 35 35 38 35 35 35 35 35 35 35 35 35 35 35 35 35 35 35 35 35 35 35 36 
36 35 35 38 38 36 35 35 36 35 35 35 34 36 35 35 35 35 35 35 35 35 35 35 35 35 35 35 35 35 35 35 35 35 35 35 35 35 35 35 35 35 35 35 35 35 35 35 35 36 
36 35 35 35 35 36 34 34 36 35 35 35 38 36 35 35 35 35 35 35 35 35 35 35 35 35 35 35 35 35 35 35 35 35 35 35 35 35 35 35 35 35 35 38 35 35 35 35 35 36 
36 35 36 36 36 36 35 34 36 36 36 36 36 36 35 35 35 35 35 35 35 35 35 35 35 35 35 35 35 34 35 35 35 35 35 35 35 35 35 35 35 35 35 38 35 35 35 35 35 36 
36 35 35 35 35 35 35 35 35 35 35 35 35 36 36 36 36 36 36 36 35 35 35 35 35 35 35 35 35 35 35 35 35 35 35 35 35 35 35 35 35 35 35 38 35 35 35 35 35 36 
36 35 35 35 35 35 35 35 35 35 35 35 35 36 36 36 36 36 36 36 36 36 36 36 36 36 36 36 35 35 35 35 35 35 35 35 35 35 35 35 35 35 35 35 35 35 35 35 35 36 
36 34 35 35 35 38 35 35 35 35 35 35 35 35 35 35 40 45 45 45 45 45 45 45 45 45 41 36 35 35 35 35 35 35 35 38 35 35 35 35 35 35 35 35 35 35 35 35 35 36 
36 35 35 35 35 35 35 35 35 35 35 35 35 35 35 35 44 34 34 34 34 34 34 34 34 34 46 36 35 35 35 35 35 35 35 35 35 35 35 35 35 35 35 35 35 35 35 35 35 36 
36 35 35 35 35 34 35 35 35 35 35 35 35 35 35 35 44 34 34 34 34 34 34 34 34 34 46 36 35 35 35 35 35 35 35 35 35 35 35 35 35 35 35 35 35 35 35 35 35 36 
36 35 35 35 34 34 34 35 35 35 35 35 35 35 35 35 44 34 34 34 34 34 34 34 34 34 46 36 35 34 35 35 34 34 34 35 35 35 35 35 35 35 35 35 38 35 35 35 35 36 
36 35 35 35 35 34 35 35 35 35 35 35 35 35 35 35 44 34 34 34 34 34 34 34 34 34 46 36 35 35 35 35 35 35 35 35 35 35 35 35 35 35 35 35 35 35 35 35 35 36 
36 35 35 35 35 35 35 35 35 35 35 35 35 35 35 35 44 34 34 34 34 34 34 34 34 34 46 36 35 35 35 35 35 35 35 35 35 35 35 35 35 35 38 35 35 35 35 35 35 36 
36 34 35 35 35 38 35 35 35 35 35 35 35 35 35 35 43 47 47 47 47 47 47 47 47 47 42 36 35 35 35 35 35 35 35 35 35 35 34 35 35 35 38 35 35 35 35 35 35 36 
36 36 36 36 36 36 36 36 36 36 36 36 36 36 36 36 36 36 36 36 36 36 36 36 36 36 36 36 36 36 36 36 36 36 36 36 36 36 36 36 36 36 36 36 36 36 36 36 36 36 
36 37 36 36 36 35 35 35 35 35 35 35 35 35 35 35 39 35 35 36 35 35 35 35 35 35 35 35 35 35 37 35 35 35 35 35 35 35 35 35 35 35 35 35 35 35 35 35 35 36 
36 36 36 36 35 39 34 34 34 34 34 34 34 34 34 34 34 35 35 36 35 35 35 35 35 35 35 35 35 35 35 35 35 35 35 35 35 35 35 35 35 35 35 35 35 35 35 35 35 36 
36 36 36 35 35 35 34 36 36 36 36 36 36 36 36 36 34 35 35 36 35 35 35 38 38 38 38 38 38 35 38 38 38 38 38 38 38 38 38 38 38 38 38 38 38 38 35 35 35 36 
36 36 35 35 35 35 34 36 34 34 34 34 34 34 34 36 34 35 35 36 35 35 35 38 40 45 45 45 45 45 45 45 45 45 41 38 35 38 40 45 45 45 45 45 41 38 35 35 35 36 
36 35 35 35 35 35 34 36 34 36 36 35 36 36 34 36 34 35 35 36 35 35 35 38 44 34 34 34 34 34 34 34 34 34 46 38 35 38 44 34 34 34 34 34 46 38 35 35 35 36 
36 35 35 35 35 35 34 36 34 36 35 35 35 36 34 36 34 35 35 36 35 35 35 38 44 34 34 34 34 34 34 34 34 34 46 35 34 35 44 34 34 34 34 34 46 38 35 35 35 36 
36 35 35 35 35 35 34 36 34 36 35 34 35 36 34 35 34 35 35 36 35 35 35 38 44 34 34 34 34 34 34 34 34 34 46 35 34 35 44 34 34 34 34 34 46 38 35 35 35 36 
36 35 35 35 35 35 34 36 34 36 36 36 36 36 34 36 34 35 35 36 35 35 35 38 44 34 34 34 34 34 34 34 34 34 46 38 35 38 44 34 34 34 34 34 46 38 35 35 35 36 
36 35 35 35 35 35 34 36 34 34 34 34 34 34 34 36 34 35 35 36 35 35 35 38 43 47 47 47 47 47 47 47 47 47 42 38 35 38 43 47 47 47 47 47 42 38 35 35 35 36 
36 35 35 35 35 35 34 36 36 36 36 36 36 36 36 36 34 35 35 36 35 35 35 38 38 38 38 38 38 38 38 38 38 38 38 38 38 38 38 38 38 38 38 38 38 38 35 35 35 36 
36 39 35 35 35 35 34 34 34 34 34 34 34 34 34 34 34 38 38 36 35 35 35 35 35 35 35 35 35 35 35 35 35 35 35 35 35 35 35 35 35 35 35 35 35 35 35 35 35 36 
36 39 39 35 35 35 39 35 35 35 35 35 35 35 35 35 35 35 35 36 35 35 35 35 35 35 35 35 35 35 35 35 35 35 35 35 35 35 35 35 35 35 35 35 35 35 35 35 35 36 
36 36 36 36 36 36 36 36 36 36 36 36 36 36 36 36 36 36 36 36 36 36 36 36 36 36 36 36 36 36 36 36 36 36 36 36 36 36 36 36 36 36 36 36 36 36 36 36 35 36 
36 35 35 35 35 35 35 35 35 35 35 35 35 38 35 35 37 35 35 38 35 35 35 35 35 35 35 35 35 35 35 38 35 35 35 35 38 35 35 35 34 35 35 36 35 35 35 36 35 36 
36 38 38 38 38 38 38 38 38 38 38 38 35 38 35 35 35 35 35 38 35 35 35 38 35 35 35 35 35 35 35 38 35 35 35 35 38 35 35 35 35 35 35 36 35 35 35 36 35 36 
36 38 38 38 38 38 38 38 38 38 38 38 35 38 38 38 35 38 38 38 35 38 38 38 38 38 38 38 38 35 35 38 35 35 35 35 38 35 35 35 35 35 35 36 35 34 35 36 35 36 
36 35 35 35 35 35 35 35 35 35 35 35 34 35 35 38 38 38 35 34 34 35 35 35 35 35 35 35 35 35 35 35 35 35 35 35 38 35 35 35 35 35 35 36 35 35 35 36 35 36 
36 38 38 38 38 38 38 38 38 38 38 38 38 35 35 35 38 35 35 35 38 38 38 38 38 38 38 38 38 35 35 38 35 38 38 38 38 38 38 38 35 38 35 36 35 35 35 36 35 36 
36 35 35 35 35 35 35 35 35 35 35 35 38 35 35 35 38 35 35 34 34 35 35 35 35 35 35 35 35 35 35 38 35 35 35 35 35 35 35 38 35 38 35 36 35 34 35 36 35 36 
36 35 37 35 37 35 37 35 37 35 38 35 38 35 35 35 38 35 35 35 38 38 38 38 38 38 38 38 38 35 35 38 35 35 35 35 35 35 35 38 35 38 35 36 35 35 35 36 35 36 
36 35 35 35 35 35 35 35 35 35 38 35 38 35 38 38 38 38 38 35 38 35 35 35 35 35 35 35 38 35 35 38 38 38 35 35 35 35 35 38 35 38 35 36 35 35 35 36 35 36 
36 35 37 35 37 35 37 35 37 35 38 35 38 35 35 35 38 35 35 35 38 35 35 35 35 35 35 35 38 38 38 38 35 38 38 38 38 35 35 38 35 38 35 36 35 34 35 36 35 36 
36 35 35 35 35 35 35 35 35 35 38 35 38 35 35 34 34 34 35 35 35 34 35 35 35 35 35 35 35 35 35 35 34 35 35 35 38 35 35 38 35 38 35 36 35 35 35 36 35 36 
36 38 38 38 38 38 38 38 38 38 38 35 38 38 38 38 38 38 38 38 38 35 35 35 35 35 35 35 38 38 38 38 38 38 38 35 38 38 38 38 35 38 38 36 35 35 35 36 35 36 
36 35 35 35 35 35 35 35 35 35 35 34 35 35 35 35 35 35 35 35 35 35 35 35 35 35 35 35 38 35 35 35 35 35 38 35 35 35 35 35 34 35 35 35 35 35 35 36 35 36 
36 38 38 38 38 38 38 38 38 38 38 35 38 38 38 38 35 35 35 35 38 38 38 38 38 38 38 38 38 35 38 38 38 35 38 38 38 38 38 38 35 38 38 36 36 36 36 36 35 36 
36 35 35 35 35 35 35 35 35 35 38 35 38 35 35 35 35 35 35 35 38 35 35 35 35 35 35 35 35 35 38 35 35 34 35 35 35 35 35 38 35 38 35 36 35 35 35 35 35 36 
36 38 38 38 38 38 38 38 38 35 38 35 38 35 38 38 38 38 38 38 38 35 38 38 38 38 38 38 38 38 38 35 38 38 38 38 38 38 38 38 35 35 35 36 35 36 36 36 36 36 
36 35 35 35 35 35 35 35 35 34 35 35 38 35 35 35 35 35 35 35 35 34 35 35 35 35 35 35 35 35 38 35 35 35 35 35 35 35 35 35 35 35 35 36 35 36 36 36 36 36 
36 36 36 36 36 36 36 36 36 36 36 36 36 36 36 36 36 36 36 36 36 36 36 36 36 36 36 36 36 36 36 36 36 36 36 36 36 36 36 36 36 36 36 36 36 36 36 36 36 36
