49 50 50 57 49 49 57 57 59 50 49 49 50 57 57 49 49 57 57 59 50 49 49 59 57 57 50 50 49 49 57 57 59 50 49 49 57 57 49 49 57 59 57 57 50 59 50 49 49 57 
52 48 55 48 56 48 58 48 48 48 48 60 58 48 48 56 48 48 48 48 48 48 48 48 48 48 48 48 48 48 48 48 59 48 48 48 56 48 48 48 54 48 48 54 48 48 48 48 60 52 
49 48 48 48 56 48 48 48 54 48 48 48 48 48 55 48 48 48 54 48 55 48 56 48 48 48 48 48 54 48 48 48 48 48 48 48 48 48 48 48 48 48 48 48 48 48 48 48 56 52 
51 48 48 48 56 48 48 48 48 48 55 48 56 48 55 48 48 48 48 48 48 48 48 48 48 54 48 48 48 56 48 48 48 48 54 48 48 48 54 48 48 48 48 56 48 48 54 48 48 49 
51 56 56 48 59 56 48 48 48 48 48 48 48 48 48 48 56 48 48 48 48 48 56 48 48 48 48 54 48 48 48 48 48 48 48 48 48 56 48 48 48 48 48 48 48 48 48 48 48 49 
51 48 48 48 56 56 49 49 56 56 59 56 56 59 57 57 59 56 56 57 57 57 59 56 56 56 57 57 57 49 57 56 56 49 56 56 56 56 48 56 56 56 56 59 56 56 56 56 48 52 
59 48 48 48 56 48 48 49 48 48 48 56 48 48 48 48 56 48 55 48 56 56 48 48 48 48 48 48 48 49 48 48 48 56 48 48 48 56 48 56 48 48 48 48 48 54 48 56 54 52 
49 48 48 56 59 48 48 54 48 48 48 56 48 48 54 48 48 48 48 48 56 48 48 48 54 56 48 48 48 56 48 48 54 48 48 48 48 48 48 56 54 56 48 48 48 48 48 56 48 52 
59 56 48 48 56 48 48 48 48 48 48 48 48 56 48 48 48 48 48 48 56 48 48 48 48 55 48 48 48 52 48 48 48 48 48 56 48 48 48 56 48 48 48 48 48 48 48 56 56 50 
51 48 48 48 56 58 48 48 56 48 48 56 48 48 48 48 48 48 55 48 48 48 54 48 48 48 56 48 48 56 48 48 56 54 48 48 56 48 48 48 48 48 56 48 54 48 48 56 54 50 
59 48 56 48 56 48 48 48 48 54 48 56 48 54 48 48 48 48 48 56 56 48 48 48 48 48 48 48 48 48 48 48 48 48 48 48 48 48 56 48 48 54 48 48 48 48 48 56 54 52 
49 48 48 48 56 55 48 48 48 48 48 56 48 48 48 48 48 56 48 48 50 60 56 48 48 48 48 48 48 56 48 54 48 48 49 48 48 48 60 49 48 49 48 48 48 48 48 56 58 52 
51 54 48 48 56 48 56 56 56 48 56 56 56 57 57 56 56 59 56 50 50 50 56 56 56 56 56 56 56 48 56 56 56 59 49 56 56 56 49 48 49 49 48 56 56 59 56 48 48 49 
51 48 48 48 59 48 48 56 48 48 48 48 48 48 56 48 48 48 48 48 48 48 48 48 48 54 48 58 48 48 48 48 48 48 48 48 54 48 48 48 48 56 48 48 48 48 48 48 48 49 
52 48 48 48 56 54 48 48 48 55 48 54 48 48 48 60 48 48 48 48 54 48 48 48 48 48 48 56 48 55 48 48 48 56 48 48 48 48 55 48 48 54 56 56 48 56 54 48 48 52 
49 48 48 48 59 48 48 48 48 48 56 48 48 48 48 48 48 56 48 48 48 48 48 48 48 48 48 56 48 48 48 56 48 48 48 56 48 48 56 48 48 48 48 48 48 48 48 48 48 52 
49 48 48 48 56 48 48 48 56 48 56 48 48 48 48 56 48 48 48 48 48 48 54 55 54 48 48 56 48 48 48 48 48 48 48 48 48 48 56 48 48 54 48 55 48 48 48 48 56 52 
51 58 58 48 56 48 48 48 48 48 56 48 54 48 48 48 48 56 48 48 48 48 48 48 48 48 48 48 48 48 54 48 48 48 54 48 54 48 48 48 48 48 56 48 54 48 48 48 48 49 
51 48 48 48 56 48 55 48 48 48 48 48 48 48 48 48 48 48 48 54 48 48 55 48 48 48 48 48 56 48 48 48 48 48 56 60 48 48 48 48 55 48 48 48 48 48 56 55 48 49 
50 48 48 56 48 56 56 56 56 56 59 59 56 56 56 56 56 56 56 56 56 56 56 56 56 59 56 56 56 56 56 59 56 56 56 56 56 56 56 56 56 56 56 56 56 56 48 48 48 52 
59 48 48 48 56 48 48 48 54 48 48 48 48 48 48 48 56 54 48 48 48 48 48 48 48 48 48 48 48 48 48 48 54 48 48 56 48 48 48 48 48 48 48 54 48 48 48 56 56 52 
59 56 56 48 48 48 48 48 48 48 54 48 48 48 48 48 48 48 48 48 48 48 48 48 48 49 48 55 54 48 48 48 48 48 48 48 48 54 48 48 48 48 48 48 48 56 56 51 50 52 
51 48 48 54 48 48 56 56 56 56 56 56 56 56 56 56 56 56 56 56 56 56 50 49 49 49 49 49 50 56 56 56 56 56 56 56 56 56 56 56 56 56 56 56 56 56 56 49 56 56 
49 55 48 48 56 48 48 48 48 48 48 54 48 48 48 48 48 48 60 54 48 48 48 48 48 49 48 48 48 54 48 48 48 48 48 54 48 48 54 48 48 48 56 50 50 49 51 51 49 50 
52 52 49 49 50 52 50 52 52 49 49 49 50 50 52 52 52 49 49 52 52 52 50 50 52 52 52 49 49 49 52 52 52 50 50 49 49 52 52 49 49 52 49 52 52 52 52 50 50 50 
52 48 48 48 48 48 48 48 48 48 48 48 48 48 48 48 48 54 48 48 48 48 48 48 48 48 48 48 48 48 48 48 48 59 48 48 48 48 48 48 48 48 48 48 48 48 48 48 48 52 
52 48 48 48 48 48 48 48 48 48 48 48 48 48 48 48 48 48 48 48 48 59 48 48 55 48 48 55 59 54 48 48 48 48 48 48 48 48 48 48 48 48 48 48 48 48 48 48 48 52 
52 48 48 48 48 48 48 48 55 48 48 48 48 55 55 48 48 48 48 48 54 48 48 48 48 48 48 48 48 59 48 48 55 48 48 48 48 55 48 48 48 52 48 48 48 48 48 48 48 52 
52 48 48 48 48 48 48 48 48 48 48 48 48 48 48 56 56 56 56 56 56 56 56 56 56 56 56 56 56 56 56 56 56 56 56 56 48 55 48 52 48 48 52 48 48 48 48 48 48 52 
52 48 48 48 48 48 48 55 48 48 48 48 59 48 48 56 48 48 48 48 48 48 48 48 48 48 48 48 48 48 48 48 48 48 48 56 48 48 48 48 48 48 48 48 48 48 48 48 48 52 
52 48 48 48 48 48 48 59 48 48 48 48 48 48 48 56 48 48 48 48 48 48 48 48 48 48 48 48 48 48 48 48 48 48 48 56 48 48 48 48 48 48 48 48 48 54 48 48 48 52 
52 48 48 48 48 48 48 48 48 48 48 54 48 48 48 56 48 48 48 48 48 48 48 48 48 48 48 48 48 48 48 48 48 48 48 56 48 48 54 55 48 48 48 48 48 48 48 48 48 52 
52 48 48 54 48 48 48 48 48 48 48 48 48 55 48 56 48 48 48 48 48 48 48 48 48 48 48 48 48 48 48 48 48 48 48 56 48 48 52 48 48 48 52 48 48 52 48 48 54 52 
52 48 48 48 48 48 48 48 48 48 48 48 48 48 48 56 48 48 48 48 48 48 48 48 48 48 48 48 48 48 48 48 48 48 48 56 48 48 48 48 48 48 48 48 48 48 48 48 48 52 
52 48 48 48 48 48 48 48 52 48 48 48 55 48 48 56 48 48 48 48 48 48 48 48 48 48 48 48 48 48 48 48 48 48 48 56 48 54 48 55 48 48 48 48 54 48 48 48 48 52 
52 48 48 48 54 48 48 48 48 48 48 48 48 48 48 56 48 48 48 48 48 48 48 48 48 48 48 48 48 48 48 48 48 48 48 56 48 48 48 48 48 48 48 48 48 48 48 48 48 52 
52 48 48 48 48 48 48 48 52 48 48 48 48 48 48 56 48 48 48 48 48 48 48 48 48 48 48 48 48 48 48 48 48 48 48 56 48 48 48 48 48 48 48 48 48 48 48 48 48 52 
52 48 48 48 48 48 48 48 48 48 52 48 48 54 48 56 48 48 48 48 48 48 48 48 48 48 48 48 48 48 48 48 48 48 48 56 48 48 55 48 48 48 48 48 59 48 48 48 48 52 
52 48 48 48 48 48 52 48 48 48 48 48 48 48 48 56 48 48 48 48 48 48 48 48 48 48 48 48 48 48 48 48 48 48 48 56 48 48 48 48 54 48 48 48 48 48 48 48 48 52 
52 48 48 48 48 48 48 48 48 48 48 48 55 48 48 56 48 48 48 48 48 48 48 48 48 48 48 48 48 48 48 48 48 48 48 56 48 52 48 48 48 48 48 48 48 48 48 48 48 52 
52 48 48 48 48 54 48 48 48 48 54 48 48 48 52 56 48 48 48 48 48 48 48 48 48 48 48 48 48 48 48 48 48 48 48 56 48 55 48 48 48 48 48 48 54 48 48 48 48 52 
52 48 48 48 48 54 52 48 48 48 48 48 55 48 48 56 48 48 48 48 48 48 48 48 48 48 48 48 48 48 48 48 48 48 48 56 48 48 54 48 48 48 48 48 54 48 48 48 48 52 
52 48 48 48 48 48 48 48 48 48 48 48 48 48 48 56 48 48 48 48 48 48 48 48 48 48 48 48 48 48 48 48 48 48 48 56 48 48 48 48 48 48 48 48 48 48 48 48 48 52 
52 48 48 48 48 48 48 48 48 48 48 48 48 48 48 56 48 48 48 48 48 48 48 48 48 48 48 48 48 48 48 48 48 48 48 56 48 55 48 52 48 48 48 48 55 48 48 48 48 52 
52 48 48 48 54 48 48 48 48 48 48 59 48 48 48 56 56 56 56 56 56 56 56 56 56 56 56 56 56 56 56 56 56 56 56 56 54 48 48 48 48 54 48 48 48 48 48 48 48 52 
52 48 48 48 48 48 48 48 48 48 48 48 48 48 48 48 54 48 48 48 48 48 55 48 48 48 48 48 48 48 48 48 48 48 48 48 48 55 48 48 48 48 54 48 48 48 48 48 48 52 
52 48 48 48 48 48 48 48 48 48 48 48 48 48 48 48 48 48 48 54 48 48 48 48 48 48 48 55 48 48 48 48 48 48 48 48 48 48 55 48 48 48 48 48 48 48 48 48 48 52 
52 48 48 48 48 48 48 48 48 48 48 54 48 48 48 48 48 55 48 48 48 48 48 48 48 55 48 48 52 48 48 48 54 48 48 48 48 48 48 55 48 48 55 48 48 48 48 55 48 52 
52 48 48 48 48 48 48 48 48 48 48 48 48 48 48 48 48 48 48 48 48 48 48 48 48 48 48 48 48 48 48 48 48 48 48 48 48 48 48 48 48 48 48 48 48 48 48 48 48 52 
52 52 52 52 52 52 52 52 52 52 52 52 52 52 52 52 52 52 52 52 52 52 52 52 52 52 52 52 52 52 52 52 52 52 52 52 52 52 52 52 52 52 52 52 52 52 52 52 52 52
