110 112 112 112 112 112 112 112 112 112 112 112 112 112 112 112 112 112 112 112 112 112 112 112 112 112 112 112 112 112 112 112 112 112 112 112 112 112 112 112 112 112 112 112 112 112 112 112 112 80 
113 85 84 84 84 84 84 84 84 84 84 84 84 84 84 84 84 83 92 76 76 76 76 101 93 93 93 93 93 93 93 93 93 93 93 93 93 93 93 93 93 93 93 93 93 93 93 93 99 111 
113 66 69 69 69 69 69 69 69 69 69 69 69 69 69 69 69 67 92 76 76 76 76 95 85 84 84 84 84 84 84 84 84 84 84 84 84 84 84 84 84 84 84 84 84 84 84 83 92 111 
113 66 69 69 109 69 109 69 69 69 69 69 69 69 69 69 69 67 92 76 76 76 76 95 66 69 69 69 69 69 69 69 69 69 69 69 69 69 69 109 109 109 69 69 69 69 69 67 92 111 
113 66 69 69 109 69 69 69 69 69 69 69 69 69 69 109 69 67 92 76 76 76 76 95 66 69 69 69 69 69 69 69 69 109 109 69 69 69 69 69 109 109 69 69 69 69 69 67 92 111 
113 66 69 69 69 69 69 69 69 109 69 69 69 69 69 109 69 67 92 76 76 76 76 95 66 69 69 69 69 69 69 69 109 109 69 69 69 69 109 69 69 69 69 69 69 69 69 67 92 111 
113 66 109 109 69 69 69 69 69 69 69 69 69 69 69 109 109 67 92 76 76 76 76 95 66 69 69 69 69 69 69 69 109 109 69 69 69 69 69 69 69 69 69 69 69 69 69 67 92 111 
113 66 109 69 69 69 69 69 69 69 69 69 69 109 69 69 69 67 92 76 76 76 76 95 66 69 69 69 69 69 69 69 69 69 69 69 69 109 69 69 69 69 69 69 109 69 69 67 92 111 
113 66 69 69 69 69 69 69 69 86 68 68 68 68 68 68 68 82 92 76 76 76 76 95 66 68 68 68 68 68 88 69 69 69 69 69 69 69 69 69 69 69 69 69 69 69 69 67 92 111 
113 66 69 69 69 69 69 69 109 67 91 90 90 90 90 90 90 90 98 76 76 76 76 100 90 90 90 90 90 97 66 69 69 69 69 69 69 69 69 69 109 69 69 69 69 69 69 67 92 111 
113 66 109 69 69 109 69 69 69 67 92 76 76 76 76 76 76 76 76 76 76 76 76 76 76 76 76 76 76 95 66 109 69 69 69 69 69 69 69 69 69 69 69 69 69 69 109 67 92 111 
113 66 69 69 109 109 69 69 69 67 92 76 76 76 76 76 76 76 76 76 76 76 76 76 76 76 76 76 76 95 81 68 68 68 68 68 68 68 68 103 68 68 68 68 68 68 68 82 92 111 
113 66 69 69 69 69 69 69 69 67 92 76 76 76 76 76 76 76 76 76 76 76 76 76 76 76 76 76 76 100 90 90 90 90 90 90 90 90 90 90 90 90 90 90 90 90 90 90 98 111 
113 66 69 69 69 69 69 109 69 67 94 93 93 93 93 99 76 76 76 76 76 76 76 76 76 76 76 76 76 76 76 76 76 76 76 76 76 76 76 76 76 76 76 76 76 76 76 76 76 111 
113 66 109 109 109 109 109 109 109 109 84 84 84 84 83 92 76 76 76 76 76 76 76 76 76 76 76 76 76 76 76 76 76 76 76 76 76 76 76 76 76 76 76 76 76 76 76 76 76 111 
113 66 69 69 69 69 69 69 69 69 69 69 69 69 67 92 76 76 76 76 76 76 76 76 76 76 76 76 76 101 93 93 93 93 93 93 93 93 93 93 93 93 93 93 93 93 93 93 93 111 
113 66 69 69 69 69 69 69 69 69 69 69 69 69 67 92 76 76 76 76 76 76 76 76 76 76 76 76 76 95 85 84 84 84 84 84 84 84 84 84 84 84 84 84 84 84 84 84 83 111 
113 66 69 69 69 69 69 69 69 69 69 69 69 69 67 92 76 76 76 76 76 76 76 76 76 76 76 76 76 95 66 69 69 69 69 69 69 69 69 69 69 69 69 69 69 69 109 69 67 111 
113 66 69 69 69 69 69 69 69 69 69 69 69 69 67 92 76 76 76 76 76 76 76 76 76 76 76 76 76 95 66 69 69 69 69 109 69 69 69 69 69 69 69 69 69 69 69 69 67 111 
113 66 69 69 69 69 69 69 69 69 69 69 69 69 67 92 76 76 76 76 76 76 76 76 76 76 76 76 76 95 66 69 69 109 109 109 109 69 69 69 69 69 69 69 69 69 69 69 67 111 
113 66 69 69 69 69 69 69 69 69 69 69 69 69 67 92 76 76 76 76 76 76 76 76 76 76 76 76 76 95 66 69 69 109 109 109 69 69 69 69 69 69 69 69 69 69 69 109 67 111 
113 66 69 69 69 69 69 69 69 69 69 69 69 69 67 92 76 76 76 76 76 76 76 76 76 76 76 76 76 95 66 69 69 69 69 69 69 69 69 109 69 69 69 69 69 69 69 69 67 111 
113 66 69 69 69 69 69 69 69 69 69 69 69 69 67 92 76 76 76 76 76 76 76 76 76 76 76 76 76 95 66 69 69 69 109 69 69 69 69 69 69 69 69 69 69 69 69 69 67 111 
113 66 69 69 69 69 69 69 69 69 69 69 69 69 107 92 76 76 76 76 76 76 76 76 76 76 76 76 76 95 66 109 69 69 69 69 69 69 69 69 69 69 69 69 109 69 69 69 67 111 
113 81 68 68 68 68 68 68 68 68 68 68 68 68 82 92 76 76 76 76 76 76 76 76 76 76 76 76 76 95 66 69 69 69 69 109 69 69 69 69 69 69 69 69 69 69 69 69 67 111 
113 90 90 90 90 90 90 90 90 90 90 90 90 90 90 98 76 76 76 76 76 76 76 76 76 76 76 76 76 95 66 69 69 69 69 69 69 69 109 69 69 69 69 69 69 69 69 69 67 111 
113 76 76 76 76 76 76 76 76 76 76 76 76 76 76 76 76 76 76 76 76 76 76 76 76 76 76 76 76 95 66 69 69 109 69 69 86 68 68 105 68 68 68 88 69 69 69 69 67 111 
113 76 76 76 76 76 76 76 76 76 76 76 76 76 76 76 76 76 76 76 76 76 76 76 76 76 76 76 76 95 65 69 69 69 69 69 67 91 90 90 90 90 97 65 69 69 69 109 67 111 
113 76 76 76 76 76 76 76 76 76 76 76 76 76 76 76 76 76 76 76 76 76 76 76 76 76 76 76 76 95 65 69 69 69 69 109 67 92 76 76 76 76 95 65 69 69 109 69 67 111 
113 101 93 93 93 93 93 93 93 93 93 93 93 93 93 99 76 76 76 76 76 76 76 76 76 76 76 76 76 95 66 69 109 69 69 69 67 92 76 76 76 76 95 65 69 69 69 69 67 111 
113 95 85 84 84 84 84 84 84 84 84 84 84 84 83 92 76 76 76 76 76 76 76 76 76 76 76 76 76 95 66 69 69 69 69 69 67 92 76 76 76 76 95 65 69 69 69 69 67 111 
113 95 66 69 69 69 69 69 69 69 69 109 69 69 67 92 76 76 76 76 76 76 76 76 76 76 76 76 76 95 81 68 68 68 68 68 82 92 76 76 76 76 95 81 68 68 68 68 82 111 
113 95 66 69 109 109 69 69 69 69 69 69 69 69 67 92 76 76 76 76 76 76 76 76 76 76 76 76 76 100 90 90 90 90 90 90 90 98 76 76 76 76 100 90 90 90 90 90 90 111 
113 95 66 69 69 69 109 69 69 69 69 69 69 69 67 92 76 76 76 76 76 76 76 76 76 76 76 76 76 76 76 76 76 76 76 76 76 76 76 76 76 76 76 76 76 76 76 76 76 111 
113 95 66 69 69 69 69 69 69 69 69 69 69 69 67 94 93 93 99 76 76 76 76 76 76 76 76 76 76 76 76 76 76 76 76 76 76 76 76 76 76 76 76 76 76 76 76 76 76 111 
113 95 81 68 68 68 68 68 88 69 69 69 69 69 87 84 84 83 92 76 76 76 76 76 76 76 76 76 76 101 93 93 93 93 93 93 93 99 76 76 76 76 101 93 93 93 93 93 99 111 
113 100 90 90 90 90 90 97 66 69 69 69 69 69 69 69 69 67 92 76 76 76 76 76 76 76 76 76 76 95 85 84 84 84 84 84 83 92 76 76 76 76 95 85 84 84 84 83 92 111 
113 76 76 76 76 76 76 95 106 69 69 69 69 69 69 69 69 67 92 76 76 76 76 76 76 76 76 76 76 95 66 69 69 69 69 69 67 92 76 76 76 76 95 66 69 69 69 67 92 111 
113 101 93 93 93 93 93 96 66 69 69 69 69 109 69 69 69 67 92 76 76 76 76 76 76 76 76 76 76 95 66 69 69 69 69 69 67 92 76 76 76 76 95 66 69 69 69 67 92 111 
113 95 85 84 84 84 84 84 89 69 109 69 69 69 69 69 69 67 92 76 76 76 76 76 76 76 76 76 76 95 66 69 69 69 69 69 67 92 76 76 76 76 95 66 69 69 69 67 92 111 
113 95 66 69 69 69 69 109 69 69 69 69 69 69 109 69 69 67 92 76 76 76 101 93 93 93 93 93 93 96 106 69 69 69 69 69 67 94 93 93 93 93 96 66 69 69 69 67 92 111 
113 95 66 69 69 69 69 69 69 69 69 69 69 109 109 69 69 67 92 76 76 76 95 85 84 84 84 84 84 84 89 69 69 69 69 69 87 84 84 84 84 84 84 89 69 69 69 67 92 111 
113 95 66 69 69 69 109 82 69 69 69 109 69 69 69 69 69 67 92 76 76 76 95 66 69 69 69 69 69 69 86 68 68 68 88 69 69 69 69 69 69 86 104 105 68 68 68 82 92 111 
113 95 66 69 109 69 69 69 69 109 69 69 69 69 69 69 69 67 92 76 76 76 95 66 69 69 69 69 69 69 67 91 90 97 65 69 69 69 69 69 86 82 91 90 90 90 90 90 98 111 
113 95 66 69 69 69 69 69 69 69 69 69 86 68 68 68 68 82 92 76 76 76 95 66 69 69 69 69 69 69 67 92 76 95 65 69 69 69 69 69 67 91 102 93 93 93 93 93 76 111 
113 95 66 69 69 69 109 69 69 69 69 69 67 91 90 90 90 90 98 76 76 76 95 66 69 69 69 69 69 69 67 94 93 96 65 69 69 69 69 69 67 94 96 85 84 84 84 83 92 111 
113 95 66 69 69 69 69 69 69 69 69 69 67 92 76 76 76 76 76 76 76 76 95 66 69 69 69 69 69 69 87 84 84 84 89 69 69 69 69 69 109 84 84 89 69 69 69 67 92 111 
113 95 81 68 68 68 68 68 68 68 68 68 67 92 76 76 76 76 76 76 76 76 95 66 69 69 69 69 69 69 69 69 69 69 69 69 69 69 69 69 109 109 109 69 69 69 69 67 92 111 
113 100 90 90 90 90 90 90 90 90 90 90 90 98 76 76 76 76 76 76 76 76 95 81 68 68 68 68 68 68 68 68 68 68 68 68 68 68 68 68 68 68 68 68 68 68 68 82 92 111 
78 114 114 114 114 114 114 114 114 114 114 114 114 114 114 114 114 114 114 114 114 114 114 114 114 114 114 114 114 114 114 114 114 114 114 114 114 114 114 114 114 114 114 114 114 114 114 114 114 79